1111111111111111
1000000000000101
1000000000000001
1000000000000001
1001000301100001
1001001111000001
1001000000001001
1000000000001101
1000000000001101
1000020000000001
1000000000001101
1011000000000001
1011000000000001
1001000000000001
1000000000000011
1111111111111111