1111111111111111
1100000000000021
1100000010000001
1100000010000001
1000000010300001
1000000010000001
1000100000000001
1000100010001001
1000100000000001
1000001000000001
1000001000000011
1000000000000001
1000000000000001
1000000000000001
1000000000000001
1111111111111111