1111111111111111
1000000010010001
1000300010000001
1000000010000001
1100000010000011
1000000000000001
1000000000000001
1000000020000001
1000000000000001
1000000000000001
1000000000000001
1000000000000001
1000000000000001
1000000000000011
1000000000000011
1111111111111111